10 5 5 0.01 1
O O O O O O O O O O
O - - - - - - - - O
O - - - - - - - - O
O - - O - - O - - O
O - - - - - - - - O
O - - - - - - - - O
O - - O - - O - - O
O - - - - - - - - O
O - - - - - - - - O
O O O O O O O O O O